Meine |
vom Herzen|aufrichtig
den|Deinen
erfreulichen|sehr willkommenen
Lieferungsvertrag|Auftrag
Dich|Deine Firma
vertraulich |
wir|unsere Ingenieure
Herausragendes|Sensationelles
Köchern|Reagenzgläsern
halten|haben
plastisch |
denken|vorstellen
dahinter|darin
einzige|erste
grosse|ansehnliche
Menge|Anzahl
Fläschen|Muster
kostenlos|gratis
kriegen|erhalten
die Summe|den Betrag
Schweizer Franken|CHF
mit der |
von der|der
in|4001
CH |
hoffe|freue mich
geholfen|gedient
schliesse ich|verbleibe ich
lieben|freundlichen
Dein |
Geschäftsführer|CEO